P,-1,-1,9,1
P,5,0,3,2
P,8,-5,5,1
P,13,-1,5,1
P,18,-6,8,10
P,23,-12,6,3
P,20,-18,6,3
P,20,-24,3,3
P,26,-24,3,3
P,15,-30,6,3
P,11,-36,28,6
P,8,-41,9,1
P,17,-43,7,1
P,24,-42,22,2
P,27,-40,5,2
P,46,-40,1,18
P,42,-38,4,2
P,39,-34,4,2
P,42,-30,4,2
P,39,-26,4,2
P,39,-22,2,2
P,44,-22,2,2
P,63,-42,2,1
P,46,-21,9,1
P,54,-31,1,10
P,55,-31,20,1
P,75,-31,1,10
P,75,-21,5,1
P,80,-23,6,3
P,82,-29,6,3
P,80,-35,6,3
P,73,-43,7,1
P,68,-42,5,5
P,68,-38,2,2
P,68,-51,4,1